8 16
################
#..............#
#..0...........#
#.........2....#
#..............#
#..1...........#
#..............#
################
